R 1920 1080       
NO ./textures/redbrick.xpm  
SO ./textures/redbrick.xpm  
WE ./textures/redbrick.xpm
EA ./textures/redbrick.xpm

S ./textures/barrel.xpm
F 220,100,80
C 150,80,200

111111111111111111111111111111111
100000001000000000110000000000001
1000000010110000011100000000200011
1000000010010000000000000000N0001
1111111110110000011100000000000011
100000000011000001110111110111111
11110111111111011100000010001
11110111111111011101010010001
11000000110101011100000010001
10002000000000001100000010001
10000000000000001101010010001
11000001110101011111011110001
11110111 1110101 101111010001
11111111 1111111 111111111111
