        1111111111111111111111111
        1000000000110000000000001
        10110000011100000020000011
        100100000000000000000000E1
1111111110110000011100000000000011
100000000011000001110111110111111
11110111111111011100000010001
11110111111111011101010010001
11000000110101011100000010001
10002000000000001100000010001
10000000000000001101010010001
11000001110101011111011110001
11110111 1110101 101111010001
11111111 1111111 111111111111
